AD	andorre
AE	eau	u arab emirates	uae
AF	afghanistan
AL	albanie
AM	arménie	armenia
AO
AR	argentine	argentina
AT	autriche	austria
AU	australia	australie
AZ
BA	bosnia	bosnia and herzegovina	bosnie-herzegovine
BD	bangladesh
BE	belgium	belgique
BF	burkina faso
BG	bulgarie	bulgaria
BI	burundi
BJ	benin
BN	brunei darussalam
BO	bolivie	bolivia	Plurinational State of Bolivia
BR	brasil	brésil	bresil
BT	bhoutan
BW	botswana
BY	biélorussie	belarus	bielorussia
BZ
CA	canada
CD	democratic republic of the congo	democratic republic of congo	congo democratic republic of	RDC
CF	république centrafricaine	centreafrique
CG	république du congo	congo-brazzaville
CH	switzerland	suisse	république helvétique
CI	côte d'ivoire
CL	chile	chili
CM	cameroun	cameroon
CN	chine	china	中国
CO	colombia	colombie
CR	costa rica
CU
CY	chypre
CZ	tchéquie	république tchèque
DE	germany	allemagne	deutschland
DJ
DK	denmark
DO	dominican republic	republica dominicana
DZ	algérie	algerie
EC	équateur	equateur
EE	estonie
EG	égypte
EH
ER
ES	spain	espagne	españa
ET	ethiopia
FI	Finlande
FJ
FK
FR	france	guadeloupe	fr
GA
GB	united kingdom	united kingdon	england	u.k.	uk	britain
GE
GF	guyane
GH	ghana
GL	groenland
GM	gambie	the gambia
GN	guinée
GQ	guinée équatoriale
GR	grèce	greece
GT	guatemala
GW	guinée bissau
GY
HN	honduras
HR	croatie
HT	haïti	haiti
HU	magyar	hongrie
ID	indonesia	indonésie
IE	irlande	ireland
IL	israel
IN	india	inde
IQ	irak
IR	Islamic Republic of Iran
IS	islande
IT	italie	italia
JM
JO	jordanie	jordan
JP	japon	日本
KE	kenya
KG	kyrgyzstan
KH	cambodia
KP	Korea, North	Democratic People's Republic of Korea	DPRK
KR	Korea, South	south korea	korea, south	Republic of Korea	RK	korea
KW	koweit
KZ
LA	Lao People's Democratic Republic	LPDR
LB	liban	lebanon
LK	sri lanka
LR
LS
LT	lithuania
LU	Luxemburg
LV
LY
MA	maroc
MD	moldavie	Republic of Moldova
MG
MK	macédoine	Former Yugoslav Republic of Macedonia	makedonia
ML	mali	mali
MM	birmanie	burma
MN	mongolie
MR	mauritanie
MW	malawi
MX	méxico	mexico	mexique
MY	malaysia
MZ	mozambique
NA	namibia
NC
NE
NG	abuja-nigeria	nigeria	nigeria/australia
NI
NL	pays-bas	the netherlands and egypt	netherlands	the netherlands
NO	norvège	norway
NP	népal	nepal
NZ	nouvelle- zélande	new zealand
OM	oman
PA	panama
PE	pérou	peru
PG	papua new guinea	Papouasie-Nouvelle-Guinée
PH	philippines
PK	pakistan
PL	polska	pologne
PR	porto rico
PS	palestine
PT
PY	paraguay
QA	qatar
RO	roumanie	romania
RS	serbie	republic of serbia	republika srpska
RU	russie	russian federation	Росси́я	Россия	россия
RW	rwanda
SA	arabie saoudite
SB
SD
SE	suède	sverige	sweden
SG	singapour	singapore
SI	slovénie	slovenia
SJ
SK	slovaquie
SL	Sierra Leone
SN	sénégal
SO	somalie	somalia
SR	surinam
SV	salvador	el salvador
SY	syrie	syrian arab republic	sar
SZ	swaziland
TD	Tchad
TG	togo
TH	thailande	thailand
TJ
TL
TM
TN	tunisie
TR	turquie	turkey
TW	taiwan	Province of China Taiwan
TZ	tanzanie	tanzania in east africa	tanzania	usa & tanzania
UA	ukraina	Украина.Одесса
UG	Ouganda	uganda-africa	uganda
US	USA	united state of america	united states of america	usa	united states	us	u.s.a.	america
UY
UZ
VE	Bolivarian Republic of Venezuela
VN	viet nam	vietnam
VU	Vanuatu
XK	kosovo
YE
ZA	republic of south africa	south africa	rsa
ZM	zambia and south africa	zambia
ZW	zimbabwe
